###############################################################
#.............................................................#
#..1..#.......................................................#
#.....#.......................................................#
#.....#.......................................................#
#..2..#.......................................................#
#.....#.......................................................#
#.....#.......................................................#
#..####.......................................................#
#.............................................................#
#.............................................................#
#........@....................................................#
#........@....................................................#
#........@....................................................#
#.............................................................#
#.....####....................................................#
#.............................................................#
#.............................................................#
###.#####################################.....................#
#.............................................................#
#.............................................................#
#.....#.......................................................#
#..O..#.......................................................#
#.....#.......................................................#
#.............................................................#
#.............................................................#
#.............................................................#
#.............................................................#
#.............................................................#
#.....####....................................................#
#.............................................................#
#.............................................................#
###############################################################
