###############################################################
#.............................................................#
#.....#...............................................#.......#
#.....#...............................................#.......#
#.....#...............................................#...2...#
#..1..#...............................................#.......#
#.....#...............................................#.......#
#.....#...............................................#.......#
#..####...............................................######..#
#.............................................................#
#.............................................................#
#........@....................................................#
#........@....................................................#
#........@....................................................#
#.............................................................#
#.....####....................................................#
#.............................................................#
#.............................................................#
###.#####################################.....................#
#.............................................................#
#.............................................................#
#.....#.......................................................#
#.....#.......................................................#
#.....#.......................................................#
#.............................................................#
#.............................................................#
#.............................................................#
#.............................................................#
#.............................................................#
#....#####....................................................#
#......O......................................................#
#.............................................................#
###############################################################
